show me the jobs with a salary of 50000 ?	answer(A,(job(A),salary~greater~than(A,50000,year))))
are there any project manager positions open ?	answer(A,(title(A,B),const(B,'Project Manager'),job(A))))
what java jobs are there with ibm in austin ?	answer(A,(language(A,L),const(L,java),job(A),company(A,C),const(C,'IBM'),loc(A,D),const(D,austin))))
are there any autocad jobs open ?	answer(A,(application(A,B),const(B,autocad),job(A))))
are there any jobs in houston ?	answer(A,(job(A),loc(A,B),const(B,houston))))
what jobs pay 40000 ?	answer(J,(job(J),salary~greater~than(J,40000,year))))
what microsoft jobs do not require a bscs ?	answer(J,(company(J,M),const(M,'Microsoft'),job(J),\+((req~deg(J,D),const(D,'BSCS'))))))
what ibm jobs require using java on commodores ?	answer(J,(company(J,I),const(I,'IBM'),job(J),language(J,A),const(A,java),platform(J,C),const(C,commodores))))
what jobs require 10 years of experience require a phd are in cobol and are located in texas ?	answer(J,(job(J),req~exp(J,Y),const(Y,10),req~deg(J,P),const(P,'PhD'),language(J,L),const(L,cobol),loc(J,T),const(T,texas))))
what jobs does microsoft recruit for ?	answer(J,(job(J),company(J,B),const(B, 'Microsoft'))))
show me houston jobs using c in the specialty area of oil pipeline modeling ?	answer(A,(loc(A,P),const(P,houston),job(A),language(A,L),const(L,c),area(A,S),const(S,'oil pipeline modeling'))))
show me jobs in tulsa using fortran on vax requiring a bscs ?	answer(A,(job(A),loc(A,P),const(P,tulsa),language(A,L),const(L,fortran),platform(A,H),const(H,vax),req~deg(A,D),const(D,'BSCS'))))
show me management jobs in boston requiring an mba and the knowledge of visual basic ?	answer(A,(area(A,S),const(S,management),job(A),loc(A,P),const(P,boston),req~deg(A,D),const(D,'MBA'),language(A,L),const(L,'visual basic'))))
show me jobs in computer graphics requiring a ba in art and knowledge of 'speedy3dgraphics' ?	answer(A,(job(A),area(A,S),const(S,'graphics'),req~deg(A,D),const(D,'BA'),application(A,X),const(X,'speedy3dgraphics'))))
show me the jobs at companies in austin that want a degree in bscs	answer(A,(job(A),loc(A,C),const(C,austin),des~deg(A,B),const(B,'BSCS'))))
show the jobs offering 40000 working with c on windows nt ?	answer(A,(job(A),salary~greater~than(A,40000,year),language(A,L),const(L,c),platform(A,P),const(P,'windows nt'))))
show the jobs with the title systems programmer requiring 2 years of experience	answer(A,(job(A),title(A,T),const(T,'Programmer'),req~exp(A,E),const(E,2))))
show the jobs using lisp not requiring a bscs	answer(A,(job(A),language(A,L),const(L,lisp),\+ ((req~deg(A,D),const(D,'BSCS'))))))
show me all job that are available	answer(J,job(J)))
show the companies that are looking for bscs in austin	answer(C,(company(X,C),req~deg(X,D),const(D,'BSCS'),loc(X,A),const(A,austin))))
what are the jobs that require experience with microsoft word ?	answer(J,(job(J),req~exp(J),application(J,M),const(M,'microsoft word'))))
are there any jobs using 'c++' with dell ?	answer(A,(job(A),language(A,C),const(C,'c++'),company(A,B),const(B,'Dell'))))
are there ada jobs outside austin ?	answer(A,(language(A,B),const(B,ada),job(A),\+ ((loc(A,C),const(C,austin))))))
show me the jobs using java with salaries greater than 50000	answer(B,(job(B),language(B,L),const(L,java),salary~greater~than(B,50000,year))))
show me the jobs that require 2 years experience	answer(A,(job(A),req~exp(A,B),const(B,2))))
list the jobs requiring java a bscs 2 years experience	answer(A,(job(A),language(A,J),const(J,java),req~deg(A,B),const(B,'BSCS'),req~exp(A,E),const(E,2))))
are there any programmer jobs open ?	answer(A,(job(A),title(A,P),const(P,'Programmer'))))
what jobs are in seattle that are not at microsoft ?	answer(A,(job(A),loc(A,B),const(B,seattle),\+ ((company(A,N),const(N,'Microsoft'))))))
what jobs as manufacturing manager pay 100000 ?	answer(A,(job(A),title(A,C),const(C,'Manufacturing Manager'),salary~greater~than(A,100000,year))))
are there any jobs using java that dont require a bscs ?	answer(A,(job(A),language(A,B),const(B,java),\+ ((req~deg(A,B),const(B,'BSCS'))))))
show me the 'c++' jobs in nashville that desire 2 years experience	answer(A,(language(A,B),const(B,'c++'),job(A),loc(A,C),const(C,nashville),des~exp(A,E),const(E,2))))
show me the jobs using lisp requiring a bscs ?	answer(A,(job(A),language(A,L),const(L,lisp),req~deg(A,D),const(D,'BSCS'))))
are there any jobs in 'c++' that the salary is 50000 ?	answer(A,(job(A),language(A,L),const(L,'c++'),salary~greater~than(A,50000,year))))
show me the jobs that are not in haskell ?	answer(A,(job(A),\+ ((language(A,L),const(L,haskell))))))
are there any jobs at applied materials that require a bscs ?	answer(A,(job(A),company(A,C),const(C,'Applied Materials'),req~deg(A,D),const(D,'BSCS'))))
are there any jobs that require the knowledge of linux platform ?	answer(A,(job(A),platform(A,P),const(P,linux))))
show me the jobs requiring 3 years of experience at ibm ?	answer(J,(job(J),req~exp(J,T),const(T,3),company(J,C),const(C,'IBM'))))
what jobs using fortran are there in houston ?	answer(J,(job(J),language(J,F),const(F,fortran),loc(J,L),const(L,'houston'))))
show me the networking jobs in houston with a salary of 50000 ?	answer(J,(area(J,A),const(A,networking),job(J),loc(J,L),const(L,houston),salary~greater~than(J,50000,year))))
show me the senior development engineer jobs which require a master ?	answer(J,(title(J,T),const(T,'Senior Development Engineer'),job(J),req~deg(J,D),const(D,master))))
what jobs desire 2 years of experience with powerbuilder on windows nt ?	answer(J,(job(J),des~exp(J,T),const(T,2),language(J,A),const(A,powerbuilder),platform(J,P),const(P,'windows nt'))))
show me houston jobs using 'c++' on pc ?	answer(A,(loc(A,C),const(C,houston),job(A),language(A,L),const(L,'c++'),platform(A,P),const(P,pc))))
what oracle jobs are there with compaq in houston using pcs ?	answer(A,(language(A,L),const(L,oracle),job(A),company(A,C),const(C,'Compaq'),loc(A,C),const(C,houston),platform(A,P),const(P,pc))))
are there any jobs in austin requiring at least a mscs and knowing latex ?	answer(A,(job(A),loc(A,Z),const(Z,austin),req~deg(A,D),const(D,'MSCS'),language(A,L),const(L,latex))))
what are the jobs in washington that require at least 5 years of experience ?	answer(A,(job(A),loc(A,C),const(C,washington),req~exp(A,Z),const(Z,5))))
are there any jobs using java that are not with ibm ?	answer(A,(job(A),language(A,L),const(L,java),\+ ((company(A,C),const(C,'IBM'))))))
show me the jobs that operate on sun ?	answer(A,(job(A),platform(A,P),const(P,sun))))
are there any mac programmer jobs ?	answer(B,(platform(B,P),const(P,mac),title(B,A),const(A,'Programmer'),job(A))))
what are the jobs that pay 50000 per year ?	answer(J,(job(J),salary~greater~than(J,50000,year))))
show jobs in austin that require a bscs ?	answer(A,(job(A),loc(A,C),const(C,austin),req~deg(A,D),const(D,'BSCS'))))
what jobs are there for 'c++' unix developer ?	answer(A,(job(A),language(A,L),const(L,'c++'),platform(A,P),const(P,'unix'),title(A,D), const(D,'Developer'))))
what jobs are there in austin for project manager area games on mac using pascal ?	answer(A,(job(A),loc(A,B),const(B,'austin'),title(A,T),const(T,'Project Manager'),area(A,K),const(K,'games'),platform(A,W),const(W,'mac'),language(A,L),const(L,'pascal'))))
what jobs are there for assembly programer that require a bscs ?	answer(A,(job(A),language(A,S),const(S,'assembly'),req~deg(A,D),const(D,'BSCS'))))
what software engineer jobs are there that use 'c++' ?	answer(A,(title(A,S),const(S,'Software Engineer'),job(A),language(A,C),const(C,'c++'))))
what jobs in ibm in austin do not need a degree ?	answer(J,(job(J),company(J,C),const(C,'IBM'),loc(J,L),const(L,'austin'),\+(req~deg(J)))))
what jobs in austin need knowledge in unix ?	answer(J,(job(J),loc(J,L),const(L,'austin'),platform(J,P),const(P,'unix'))))
what jobs are there in austin requiring a phd ?	answer(A,(job(A),loc(A,C),const(C,'austin'),req~deg(A,D),const(D,'PhD'))))
what jobs require knowledge of 'c++' but not perl ?	answer(A,(job(A),language(A,C),const(C,'c++'),\+ ((language(A,P),const(P,'perl'))))))
what are the jobs in austin requiring knowledge of oracle ?	answer(A,(job(A),loc(A,C),const(C,'austin'),application(A,O),const(O,'oracle'))))
show me jobs with a salary greater than 50000 dollars a year ?	answer(A,(job(A),salary~greater~than(A,50000,year))))
what jobs are there for austin mac programmer using 'c++' ?	answer(A,(job(A),loc(A,C),const(C,'austin'),platform(A,P),const(P,'mac'),title(A,T),const(T,'Programmer'),language(A,L),const(L,'c++'))))
show jobs that are not in austin pay less than 10000 require knowledge of 'c++' pascal and java and desire a phd ?	answer(A,(job(A),\+((loc(A,C),const(C,'austin'))),salary~less~than(A,10000,year),language(A,L),const(L,'c++'),language(A,N),const(N,'pascal'),language(A,O),const(O,'java'),des~deg(A,D),const(D,'PhD'))))
what jobs in san antonio require the use of cobol ?	answer(A,(job(A),loc(A,L),const(L,'san antonio'),language(A,C),const(C,'cobol'))))
give me jobs that require ethernet experience but no html ?	answer(A,(job(A),area(A,E),const(E,'ethernet'),req~exp(A),\+ ((language(A,H),const(H,'html'))))))
what jobs are available that require java but not internet experience or ai experience ?	answer(A,(job(A),language(A,J),const(J,'java'),\+ (((area(A,I),const(I,'internet'),req~exp(A));(area(A,C),const(C,'ai'),req~exp(A)))))))
what jobs are there in dallas that requires a mscs ?	answer(A,(job(A),loc(A,C),const(C,'dallas'),req~deg(A,D),const(D,'MSCS'))))
what jobs are there in austin that requires experience with unix ?	answer(A,(job(A),loc(A,C),const(C,'austin'),req~exp(A),platform(A,P),const(P,'unix'))))
show me developer jobs requiring experience with mac ?	answer(A,(title(A,T),const(T,'Developer'),job(A),req~exp(A),platform(A,P),const(P,'mac'))))
what are the jobs that require experience with aix but not windows nt ?	answer(A,(job(A),req~exp(A),platform(A,X),const(X,aix), \+ ((platform(A,W),const(W,'windows nt'))))))
show a list of jobs requiring experience in 'c++' or java ?	answer(A,(job(A),req~exp(A),((language(A,C),const(C,'c++'));(language(A,J),const(J,'java'))))))
what jobs are there with a salary of more than 50000 dollars per year ?	answer(A,(job(A),salary~greater~than(A,50000,year))))
what jobs in austin or dallas desire a degree ?	answer(A,(job(A),((loc(A,P),const(P,'austin'));(loc(A,D),const(D,'dallas'))),des~deg(A))))
what jobs in austin require 10 years of experience ?	answer(A,(job(A),loc(A,P),const(P,'austin'),req~exp(A,E),const(E,10))))
what jobs in austin require knowledge of the platform unix ?	answer(A,(job(A),loc(A,P),const(P,'austin'),platform(A,U),const(U,'unix'))))
show me jobs located in austin for 'c++' programmers ?	answer(A,(job(A),loc(A,C),const(C,'austin'),language(A,C),const(C,'c++'),title(A,T),const(T,'Programmer'))))
show jobs for a shell programmer familiar with the unix environmen ?	answer(J,(job(J),language(J,L),const(L,'shell'),platform(J,P),const(P,'unix'))))
show jobs that do not require a degree for visual basic programmers ?	answer(J,(job(J),\+ req~deg(J),language(J,L),const(L,'visual basic'),title(J,T),const(T,'Programmer'))))
what jobs in austin use 'c++' and java ?	answer(A,(job(A),loc(A,C),const(C,'austin'),language(A,B),const(B,'c++'),language(A,D),const(D,'java'))))
what jobs require a bscs degree and desire an mscs degree ?	answer(A,(job(A),req~deg(A,B),const(B,'BSCS'),des~deg(A,M),const(M,'MSCS'))))
what austin jobs that use cobol do not require any experience ?	answer(A,(loc(A,B),const(B,'austin'),job(A),language(A,C),const(C,'cobol'),\+ req~exp(A))))
what jobs require knowledge of 'c++' but not perl ?	answer(A,(job(A),language(A,C),const(C,'c++'),\+ ((language(A,D),const(D,'perl'))))))
what jobs in dallas require experience with unix ?	answer(A,(job(A),loc(A,C),const(C,'dallas'),req~exp(A),platform(A,U),const(U,'unix'))))
are there any systems administrator jobs in austin ?	answer(A,(title(A,C),const(C,'Systems Administrator'),job(A),loc(A,D),const(D,'austin'))))
what jobs need knowledge of 'c++' or java ?	answer(A,(job(A),((language(A,C),const(C,'c++'));(language(A,D),const(D,'java'))))))
show me austin jobs requiring a bscs degree with a salary greater than 50000 per year ?	answer(A,(loc(A,E),const(E,'austin'),job(A),req~deg(A,D),const(D,'BSCS'),salary~greater~than(A,50000,year))))
show me jobs at dell requiring a bscs degree ?	answer(A,(job(A),company(A,B),const(B,'Dell'),req~deg(A,C),const(C,'BSCS'))))
what jobs in houston are there that requires a bscs with 1 year of experience ?	answer(A,(job(A),loc(A,H),const(H,'houston'),req~deg(A,D),const(D,'BSCS'),req~exp(A,E),const(E,1))))
what jobs in austin are there that pay at least 100000 per year ?	answer(A,(job(A),loc(A,P),const(P,'austin'),salary~greater~than(A,100000,year))))
what jobs are there in austin with a salary of at least 100000 per year ?	answer(A,(job(A),loc(A,P),const(P,'austin'),salary~greater~than(A,100000,year))))
what jobs require a msee and pays more than 100000 per year ?	answer(A,(job(A),req~deg(A,D),const(D,'MSEE'),salary~greater~than(A,100000,year))))
what jobs do not require a degree but pay more than 60000 ?	answer(J, (\+ req~deg(J),salary~greater~than(J,60000,year))))
what jobs are available for someone who knows oracle on solaris ?	answer(J, (job(J),platform(J,P),const(P,'solaris'),application(J,A),const(A,'oracle'))))
what jobs are available for a solaris systems administrator ?	answer(J, (job(J),platform(J,P),const(P,'solaris'),title(J,T),const(T,'Systems Administrator'))))
what web developer jobs are there in austin ?	answer(A,(title(A,W),const(W,'Web Developer'),job(A),loc(A,P),const(P,'austin'))))
what jobs use html but do not require a degree ?	answer(A,(job(A),language(A,H),const(H,html),\+ req~deg(A))))
show me dallas jobs requiring a bscs ?	answer(A, (loc(A,C),const(C,'dallas'),job(A),req~deg(A,D),const(D,'BSCS'))))
what web related jobs require a bscs but no experience ?	answer(A, (area(A,F),const(F,'web'),job(A),req~deg(A,D),const(D,'BSCS'),\+ req~exp(A))))
what tivoli jobs are there that require a bscs degree ?	answer(J, (company(J,C),const(C,'Tivoli'),job(J),req~deg(J,D),const(D,'BSCS'))))
what jobs are there in austin for people with knowledge of the application oracle ?	answer(J, (job(J),loc(J,L),const(L,'austin'),application(J,A),const(A,'oracle'))))
what jobs are there for programmers that know assembly ?	answer(J, (job(J),title(J,T),const(T,'Programmer'),language(J,L),const(L,'assembly'))))
are there any mac programmer jobs open in austin ?	answer(J, (platform(J,P),const(P,'mac'),title(J,T),const(T,'Programmer'),job(J),loc(J,L),const(L,'austin'))))
are there any mac jobs open ?	answer(J, (platform(J,P),const(P,'mac'),job(J))))
are there any jobs in austin paying over 100000 per year ?	answer(J, (job(J),loc(J,L),const(L,'austin'),salary~greater~than(J,100000,year))))
what jobs are there in austin that require a bscs degree ?	answer(A, (job(A),loc(A,L),const(L,'austin'),req~deg(A,D),const(D,'BSCS'))))
what jobs are there in austin that require 5 years experience ?	answer(A, (job(A),loc(A,L),const(L,'austin'),req~exp(A,Y),const(Y,5))))
what project manager jobs are there that require experience ?	answer(A, (title(A,T),const(T,'Project Manager'),job(A),req~exp(A))))
which jobs require c and 'c++' but not java ?	answer(A,(job(A),language(A,B),const(B,'c'),language(A,C),const(C,'c++'),\+ ((language(A,D),const(D,'java'))))))
what austin area web jobs require java and 'c++' ?	answer(A, (loc(A,B),const(B,'austin'),area(A,C),const(C,'web'),job(A),language(A,D),const(D,'java'),language(A,E),const(E,'c++'))))
what jobs in dallas require a bscs and 'c++' but not java ?	answer(A, (job(A),loc(A,B),const(B,'dallas'),req~deg(A,C),const(C,'BSCS'),language(A,D),const(D,'c++'),\+ ((language(A,E),const(E,'java'))))))
what jobs require a degree for pascal programmers who do not know 'c++' ?	answer(A,(job(A),req~deg(A),language(A,P),const(P,'pascal'),\+ ((language(A,C),const(C,'c++'))))))
what jobs have a salary greater than 20 and hour ?	answer(A,(job(A),salary~greater~than(A,20,hour))))
what developer jobs in austin require a bscs and 'c++' ?	answer(A,(title(A,D),const(D,'Developer'),job(A),loc(A,U),const(U,'austin'),req~deg(A,B),const(B,'BSCS'),language(A,C),const(C,'c++'))))
what jobs require a bscs and experience with oracle ?	answer(J,(job(J),req~deg(J,B),const(B,'BSCS'),req~exp(J),application(J,O),const(O,'oracle'))))
what jobs in austin require 'c++' and unix ?	answer(J,(job(J),loc(J,A),const(A,'austin'),language(J,C),const(C,'c++'),platform(J,U),const(U,'unix'))))
what are the jobs for a 'c++' programmer in austin ?	answer(J,(job(J),language(J,C),const(C,'c++'),title(J,P),const(P,'Programmer'),loc(J,A),const(A,'austin'))))
show me a job that requires 'c++' and java and is in austin ?	answer(A,(job(A),language(A,C),const(C,'c++'),language(A,D),const(D,'java'),loc(A,L),const(L,'austin'))))
what job is there for a bscs with 5 years of experience ?	answer(A,(job(A),req~deg(A,D),const(D,'BSCS'),req~exp(A,X),const(X,5))))
show me jobs that require 3 years work experience in 'c++' ?	answer(A, (job(A),req~exp(A,Y),const(Y,3),language(A,L),const(L,'c++'))))
what jobs are there which require java on windows and unix ?	answer(A, (job(A),language(A,M),const(M,'java'),platform(A,W),const(W,'windows'),platform(A,L),const(L,'unix'))))
what jobs are there for 'c++' programmers which pay more than 60000 per year ?	answer(A, (job(A),language(A,L),const(L,'c++'),title(A,T),const(T,'Programmer'),salary~greater~than(A,60000,year))))
what jobs are there outside austin which pay less than 60000 per year ?	answer(A, (job(A),\+ ((loc(A,L),const(L,'austin'))),salary~less~than(A,60000,year))))
what jobs require experience in 'c++' and java but not perl ?	answer(A,(job(A),req~exp(A),language(A,B),const(B,'c++'),language(A,C),const(C,'java'),\+ ((language(A,D),const(D,'perl'))))))
what jobs require a bscs and no experience ?	answer(A,(job(A),req~deg(A,D),const(D,'BSCS'),\+ req~exp(A))))
show me web developer job opennings at trilogy ?	answer(A,(title(A,W),const(W,'Web Developer'),job(A),company(A,C),const(C,'Trilogy'))))
what programming jobs are there in austin that uses java ?	answer(A,(job(A),loc(A,L),const(L,'austin'),language(A,B),const(B,'java'))))
show me jobs paying greater than 50000 per year ?	answer(A, (job(A),salary~greater~than(J,50000,year))))
what jobs require at least 1 year of experience in 'c++' ?	answer(A, (job(A),req~exp(A,X),const(X,1),language(A,C),const(C,'c++'))))
what jobs require 'c++' and pays a salary greater than 90000 per year ?	answer(A, (job(A),language(A,C),const(C,'c++'),salary~greater~than(A,90000,year))))
i hold a degree in bscs in austin are there any jobs for me ?	answer(A, (des~deg(A,B),const(B,'BSCS'),loc(A,P),const(P,'austin'),job(A))))
what jobs in austin require a bscs degree and deal with 'tcp/ip' ?	answer(J, (job(J),loc(J,L),const(L,'austin'),req~deg(J,D),const(D,'BSCS'),area(J,A),const(A,'tcp/ip'))))
what engineer positions in telecommunications companies in dallas do not require 'c++' ?	answer(J, (title(J,T),const(T,'engineer'),job(J),area(J,A),const(A,'telecommunications'),loc(J,L),const(L,'dallas'),\+ ((language(J,G),const(G,'c++'))))))
what web jobs are available that need mac experience and no degree ?	answer(J, (area(J,A),const(A,'web'),job(J),platform(J,P),const(P,'mac'),req~exp(J),\+ req~deg(J))))
what jobs pay at least 80000 dollars per year ?	answer(J, (job(J),salary~greater~than(J,80000,year))))
can i find a job making more than 40000 a year without a degree ?	answer(A,(job(A),salary~greater~than(A,40000,year),\+ req~deg(A))))
is ibm hiring c programmers who know unix in austin	answer(A,(company(A,C),const(C,'IBM'),job(A),language(A,L),const(L,'c'),title(A,T),const(T,'Programmer'),platform(A,P),const(P,'unix'),loc(A,N),const(N,'austin'))))
what jobs are there for programmers who know java ?	answer(A, (job(A),title(A,T),const(T,'Programmer'),language(A,P),const(P,'java'))))
what jobs in austin desiring a bscs are there for a 'c++' programmer ?	answer(A, (job(A),loc(A,C),const(C,'austin'),des~deg(A,D),const(D,'BSCS'),language(A,P),const(P,'c++'))))
are there jobs that do not require a degree in houston ?	answer(A, (job(A),\+ req~deg(A),loc(A,C),const(C,'houston'))))
show me jobs in dallas requiring knowledge of linux and pays more than 50000 a year ?	answer(A, (job(A),loc(A,C),const(C,'dallas'),platform(A,P),const(P,'linux'),salary~greater~than(A,50000,year))))
what jobs as a senior software developer are available in houston but not san antonio ?	answer(A, (job(A),title(A,W),const(W,'Senior Software Developer'),loc(A,C1),const(C1,'houston'),\+ ((loc(A,C2),const(C2,'san antonio'))))))
